


    11111111111
    10000000011
    111000E0001
    1000000P011
    100000000C1
    11111111111
