


111111111111111
100000000000000
101001010010001
101001P01010101
10000E000C00C01
111111111111111



