111111
1PC001
111101
1E0001
111111